1111111111	1111111111	0000000000	11111	
1000000221	1111111110	0000000000	01111
1000000221	1111111100	0000000000	01111
1000000001	1111111100	0000000000	01111
1000000001	1111111000	0000010001	11110
1000000001	1111111000	0000010000	03311
1000000001	1111110000	0000010000	03311
1000000001	1111110000	0000010000	00011
1100111111	1111100000	0000010000	00010
0000011111	1111100000	0000110000	00011

0000011111	1111100000	0000111111	11111	
0000011111	1111100000	0000111111	11111
0000001111	1111110000	0000011111	11111
0000000111	1111110000	0000011111	11111
0000000001	1110000000	0000001111	11111
0000000000	0000000000	0000001111	11111
1000000000	0000000000	0000011111	66111
1000000000	0000000000	0000011111	66111
1000000000	0000000000	0000111111	00111
1100000000	0000000000	0000011111	00111

1111000000	0000000000	0000000117	00111	
1111100000	0000000000	0000000000	70111
1111111100	0000000000	0000000000	01111
1111111111	1100000000	0000000000	00111
1111111111	1100000000	1000000000	00111
1100001111	1100000001	1111000000	00111
1100551111	1000000011	1111100000	00011
1100551111	1000000111	1111110000	00011
110000111	1000000111	1111110000	00011
1100111111	0000001111	1111110000	00011

1000000000	0000001111	4400010000	00011	
1000000000	0000001111	4400000000	00111
1000000000	0000011111	0000000000	00111
1100000000	0000011111	0000000000	00111
1110000000	0000111111	1111111111	01111
